[
    ["M", "M", "M", "M", "M", "M", "M", "M", "M", "M", "M", "M", "M", "M", "M", "M", "M", "M", "M", "M", "M", "M", "M", "M", "M", "M", "M", "M", "M", "M", "M", "M", "M", "M", "M", "M", "M", "M", "M", "M"],
    ["M", "T", "R", "T", "T", "R", "T", "T", "M", "T", "R", "T", "T", "T", "D", "T", "M", "T", "T", "T", "V", "T", "R", "T", "M", "V", "T", "T", "T", "T", "T", "T", "M", "T", "T", "R", "R", "T", "T", "M"],
    ["M", "T", "T", "T", "T", "T", "T", "T", "M", "T", "T", "T", "T", "T", "T", "V", "M", "V", "V", "T", "V", "T", "T", "T", "M", "V", "T", "T", "V", "T", "T", "T", "M", "T", "T", "T", "T", "V", "T", "M"],
    ["M", "V", "V", "V", "V", "V", "V", "V", "V", "V", "V", "V", "V", "V", "V", "R", "V", "R", "R", "V", "V", "V", "V", "V", "V", "R", "V", "V", "D", "V", "V", "V", "V", "V", "V", "V", "V", "R", "V", "M"],
    ["M", "D", "T", "T", "T", "T", "T", "T", "M", "T", "R", "T", "T", "T", "T", "R", "M", "T", "R", "T", "V", "T", "T", "T", "M", "T", "T", "R", "T", "T", "D", "T", "M", "T", "T", "R", "T", "R", "T", "M"],
    ["M", "T", "T", "T", "T", "T", "T", "T", "M", "T", "R", "T", "T", "T", "T", "R", "M", "T", "R", "T", "V", "T", "T", "T", "M", "T", "T", "T", "T", "T", "R", "T", "M", "T", "T", "T", "V", "T", "T", "M"],
    ["M", "M", "M", "M", "M", "M", "M", "M", "M", "M", "M", "M", "M", "M", "M", "M", "M", "M", "M", "M", "V", "M", "M", "M", "M", "M", "M", "M", "M", "M", "M", "M", "M", "M", "M", "M", "M", "M", "M", "M"],
    ["M", "T", "T", "T", "T", "R", "R", "T", "M", "T", "T", "V", "T", "T", "T", "T", "M", "T", "T", "T", "V", "T", "T", "R", "M", "T", "T", "T", "T", "V", "T", "T", "M", "T", "T", "T", "T", "T", "V", "M"],
    ["M", "T", "T", "T", "T", "T", "T", "T", "M", "T", "T", "V", "T", "T", "T", "T", "M", "T", "T", "T", "V", "T", "T", "T", "M", "T", "T", "T", "T", "R", "T", "V", "M", "T", "T", "T", "T", "T", "R", "M"],
    ["M", "V", "V", "V", "V", "V", "V", "V", "V", "V", "V", "R", "V", "V", "V", "V", "V", "V", "V", "V", "V", "V", "V", "V", "V", "V", "V", "V", "V", "R", "V", "V", "V", "V", "V", "V", "V", "V", "R", "M"],
    ["M", "R", "T", "T", "T", "T", "T", "T", "M", "T", "T", "T", "T", "R", "T", "T", "M", "T", "T", "R", "V", "T", "T", "T", "M", "T", "T", "T", "T", "T", "T", "D", "M", "T", "T", "T", "T", "T", "T", "M"],
    ["M", "R", "T", "T", "T", "T", "T", "T", "M", "T", "T", "R", "T", "T", "R", "T", "M", "T", "T", "T", "V", "T", "V", "V", "M", "T", "T", "T", "T", "T", "T", "T", "M", "R", "T", "T", "T", "R", "T", "M"],
    ["M", "T", "R", "T", "T", "T", "T", "T", "M", "T", "T", "T", "R", "T", "T", "T", "M", "T", "T", "T", "V", "T", "R", "R", "M", "T", "T", "T", "T", "T", "T", "T", "M", "R", "R", "T", "T", "R", "T", "M"],
    ["M", "M", "M", "M", "M", "M", "M", "M", "M", "M", "M", "M", "M", "M", "M", "M", "M", "M", "M", "M", "V", "M", "M", "M", "M", "M", "M", "M", "M", "M", "M", "M", "M", "M", "M", "M", "M", "M", "M", "M"],
    ["M", "R", "T", "V", "firefly", "V", "T", "T", "M", "T", "T", "T", "T", "R", "T", "R", "M", "T", "T", "T", "V", "T", "T", "T", "M", "T", "R", "D", "T", "T", "R", "T", "M", "T", "T", "T", "T", "T", "T", "M"],
    ["M", "T", "T", "T", "T", "T", "V", "T", "M", "V", "T", "T", "T", "T", "T", "T", "M", "T", "T", "V", "V", "T", "T", "T", "M", "V", "T", "T", "V", "T", "T", "T", "M", "T", "V", "T", "V", "V", "T", "M"],
    ["M", "V", "V", "V", "V", "V", "V", "V", "V", "R", "V", "V", "V", "V", "V", "V", "V", "V", "V", "D", "V", "V", "V", "V", "V", "V", "V", "V", "R", "V", "V", "V", "V", "V", "R", "V", "R", "R", "V", "M"],
    ["M", "D", "T", "T", "T", "T", "R", "T", "M", "R", "T", "T", "T", "T", "R", "T", "M", "T", "R", "T", "V", "T", "T", "R", "M", "T", "R", "T", "R", "T", "T", "T", "M", "T", "T", "T", "T", "T", "T", "M"],
    ["M", "T", "T", "T", "T", "T", "R", "T", "M", "R", "T", "T", "D", "T", "T", "T", "M", "T", "T", "T", "V", "V", "T", "T", "M", "T", "T", "R", "T", "T", "T", "T", "M", "T", "T", "T", "V", "V", "V", "M"],
    ["M", "T", "D", "T", "T", "T", "R", "V", "M", "T", "T", "V", "T", "T", "T", "T", "M", "T", "P", "D", "R", "R", "T", "T", "M", "T", "V", "T", "T", "T", "T", "T", "M", "T", "T", "T", "R", "R", "R", "M"],
    ["M", "T", "R", "T", "T", "T", "T", "R", "M", "T", "T", "R", "T", "T", "R", "T", "M", "T", "T", "T", "R", "T", "T", "T", "M", "T", "T", "T", "T", "R", "T", "R", "M", "T", "T", "T", "T", "R", "T", "M"],
    ["M", "M", "M", "M", "M", "M", "M", "M", "M", "M", "M", "M", "M", "M", "M", "M", "M", "M", "M", "M", "M", "M", "M", "M", "M", "M", "M", "M", "M", "M", "M", "M", "M", "M", "M", "M", "M", "M", "M", "M"]
]